                                                                                                                                                                                                                
                                                                                                                                                                                                                
                  123               1223                           123              1223                           123              1223                           123              1223              o 123     
        123       456      12223    4556                123        456     12223    4556                123        456     12223    4556                123        456     12223    4556              ! 456     
        456                45556                        456                45556k k                     456                45556                        456                45556                      !         
                      ?                                                         OOOOOOOO   OOO?              ?           OOO    O??O                                                        XX        !         
                                                                                                                                                                                           XXX        !         
                                                                                                                                                                                          XXXX        !         
                                                                                                                                                                                         XXXXX        !         
                ?   OKO?O                     []         []                  OKO              O     OO    ?  ?  ?     O          OO      X  X          XX  X            OO?O            XXXXXX        !         
  _                                   []      l|  _      l|                                      k_k                                    XX  XX    _   XXX  XX                          XXXXXXX    _   !         
 /,\             _          []        l|      l| /,\     l|      _                               /,\             _                     XXX  XXX  /,\ XXXX  XXX   _ []              [] XXXXXXXX   /,\  !   OO OO 
/,.,\      78889/,\ k  789  l|        l|k7889 l|/,.,\k k l|78889/,\    789                      /,.,\     n78889/,\k k 789  k k  k k  XXXX  XXXX/,.,XXXXX  XXXX9/,\l|  789    k k  l|XXXXXXXXX  /,.,\ X   OO OO9
@@@@@@@@@@@@@@@@@@@@@@@@@@@@@@@@@@@@@@@@@@@@@@@@@@@@@@@@@@@@@@@@@@@@@  @@@@@@@@@@@@@@@   @@@@@@@@@@@@@@@@@@@@@@@@@@@@@@@@@@@@@@@@@@@@@@@@@@@@@@@@@@@@@@@@  @@@@@@@@@@@@@@@@@@@@@@@@@@@@@@@@@@@@@@@@@@@@@@@@@@@@@
@@@@@@@@@@@@@@@@@@@@@@@@@@@@@@@@@@@@@@@@@@@@@@@@@@@@@@@@@@@@@@@@@@@@@  @@@@@@@@@@@@@@@   @@@@@@@@@@@@@@@@@@@@@@@@@@@@@@@@@@@@@@@@@@@@@@@@@@@@@@@@@@@@@@@@  @@@@@@@@@@@@@@@@@@@@@@@@@@@@@@@@@@@@@@@@@@@@@@@@@@@@@
